ARGUMENTS	VALUES	GROUPS
data	populations.filtered.recode.vcf	fct.call.args
strata	NULL	fct.call.args
filename	NULL	fct.call.args
vcf.stats	TRUE	fct.call.args
parallel.core	3	fct.call.args
verbose	TRUE	fct.call.args
blacklist.id	NULL	default...
filter.common.markers	TRUE	default...
filter.coverage	NULL	default...
filter.genotyping	NULL	default...
filter.individuals.coverage.iqr	NULL	default...
filter.individuals.coverage.median	NULL	default...
filter.individuals.coverage.total	NULL	default...
filter.individuals.missing	NULL	default...
filter.long.ld	NULL	default...
filter.mac	NULL	default...
filter.monomorphic	TRUE	default...
filter.short.ld	NULL	default...
filter.snp.number	NULL	default...
filter.snp.position.read	NULL	default...
filter.strands	blacklist	default...
internal	FALSE	default...
ld.method	r2	default...
long.ld.missing	FALSE	default...
markers.info	NULL	default...
parameters	NULL	default...
path.folder	NULL	default...
pop.labels	NULL	default...
pop.levels	NULL	default...
pop.select	NULL	default...
random.seed	NULL	default...
subsample.markers.stats	NULL	default...
vcf.metadata	TRUE	default...
whitelist.markers	NULL	default...
